################################################
#.........P....................................#
#..............................................#
#...........................####################
#..........................#####################
#.................##############################
################################################